NO ./textures/north.xpm
SO ./textures/south.xpm
WE ./textures/west.xpm
EA ./textures/east.xpm
F 34,139,34
C 135,206,235

111111111111111111111111111111111111111111111111
100000000000000000000000000000000000000000000001
100000000000000000111110000000000000000000000001
100000000000000000100010000000000000000000000001
100000000000000000100010000000000001111100000001
100000000000000000111110000000000001000100000001
100000000000000000000000000000000001000100000001
100000000011110000000000000000000001000100000001
100000000010010000001111000000000001000100000001
100000000010010000001001000000000001111100000001
100000000011110000001111000000000000000000000001
100000000000000000000000000000000000000000000001
100000000000000001111111100000000000000000000001
100000000000000001000001100000000000111111000001
100000000000000001000001100000000000100001000001
100000000000000001000001100000000000100001000001
100000000000000001000001100000000000100001000001
100000000000000001000001100000000000111111000001
100000000000000001111111100000000000000000000001
100000000000000000000000000000000000000000000001
100000010000000000000000000000000000000000000001
100000000000000000000000000000000000000000000001
100000000000000000000000N00000000000000000000001
100000000000000000000000000000000000000000000001
100000000000000000000000000000000000000000000001
100000000000000000000000000000000000000000000001
100000000000000000000000000000000000000000000001
100000000000000000000000000000000000000000000001
100000000000000000000000000000000000001000000001
100000000000000000000000000000000000000000000001
111111111111111111111111111111111111111111111111
